9.ox
oooooooooooooooooooo
o..................o
o..................o
o...o....o.........o
o..................o
o.............o....o
o..................o
o...o..............o
o...................
o...................