1111111111111
1000001C100C1
1010101010101
1P1C1000001E1
1111111111111