11111111111111
1P0000010000C1
10010100000111
1001C1000000E1
11111111111111