11111111111111111
100000000000000P1
10111111111111111
101C00000000000E1
10111011101010111
1000000C1C1C100C1
11111111111111111