11111111
1001CC11
1PCCC0E1
1011CC11
11111111