11111111111111111111
100000C00000000000P1
10111111111111111111
1010000000C000000001
10101111111111111101
10101E000000C0000101
1C1011111111111101C1
101000C0000000000101
10111111111111111101
100C0000000000000001
11111111111111111111