111111111111111111111111111111
100000C0000000C00000000C0000E1
1C1111111111111111111111111111
101C00C00100000011100010001C01
1010C1110001001000C01000100001
101C000011111C1010011111111101
1C1111100000010101C00000000001
101000C1101100P0C1111111111011
10101111C1000101C0000000001001
10100C000100100011111101101001
101111101000001C00000000101001
1C1C1C101011001011011111100001
101000000010001C00000000111111
10111111101C1C11111111100C0C01
100000000011111C00000000C0C0C1
111111111111111111111111111111